1111111111111111
1000010000c00001
1c00e00p00c00001
1c00000000c00001
1c00000000c00001
1c00e00000c00c01
1c00000000c00c01
1c00000000c00c01
1c00000000c00c01
1c00000000c00C01
1111111111111111