111111111111111111111
100100000111001100c11
1000ccc000000c00000p1
100011e00c01110000001
111111111111111111111